WWWWWWWWWWWWWWWWWWWWWWWWWWWWWWWWWWWWWWWWWWWWWWWWWWWWWWWWWWWWWWW
W.............................................................W
W.............................................................W
W.............................................................W
W.............................................................W
W.......WWWWW......WWWWW......................................W
W.......W..............W......................................W
W.......W..............W......................................W
W.......W..............W......................................W
W.......W..............W......................................W
W.............................................................W
W..............WW.............................................W
W..............WW.............................................W
W.............................................................W
W.......W..............W......................................W
W.......W..............W......................................W
W.......W..............W......................................W
W.......W..............W......................................W
W.......WWWWW......WWWWW......................................W
W.............................................................W
W.............................................................W
W.............................................................W
W.............................................................W
W.............................................................W
W.............................................................W
W.............................................................W
W.............................................................W
W.............................................................W
W.............................................................W
W..WWWWWW..WWWWWW..WWWWWW..WWWWWW..WWWWWW..WWWWWW..WWWWWWWWW..W
W..W....W..W....W..W....W..W....W..W....W..W....W..W.......W..W
W..W....W..W....W..W....W..W....W..W....W..W....W..W.......W..W
W..W....W..W....W..W....W..W....W..W....W..W....W..W.......W..W
W..W....W..W....W..W....W..W....W..W....W..W....W..W.......W..W
W..W....W..W....W..W....W..W....W..W....W..W....W..W.......W..W
W..WWWWWW..WWWWWW..WWWWWW..WWWWWW..WWWWWW..WWWWWW..WWWWWWWWW..W
W.............................................................W
W.............................................................W
W.............................................................W
W.............................................................W
W.............................................................W
W....................................................P........W
W.............................................................W
W.............................................................W
W.............................................................W
W.............................................................W
W.............................................................W
WWWWWWWWWWWWWWWWWWWWWWWWWWWWWWWWWWWWWWWWWWWWWWWWWWWWWWWWWWWWWWW
